111111111111111
100000000000001
101011111110111
101010000010001
101011111010101
101010001010101
1010101S1000101
101010111011111
101010000010001
101011111110101
111000000000101
100011111111101
101110001000101
1000001000101E1
111111111111111