111111111111111
100000000000001
100000000000S01
100000000111111
1000000001000E1
100000000101111
100000000101111
100000111101111
100000000001111
100000111111111
111111111111111
111111111111111
111111111111111
111111111111111
111111111111111