111111111111111
1000000101E0001
101111110111101
101000010000101
101011010110101
101010010010001
100011111011111
101000001010001
101111101000101
101000001111101
101110100000001
101000111111101
101111111111101
1S1000000000001
111111111111111