111111111111111
1000000S0000001
100000000000001
100000000000001
100000000000001
100000000000001
100000000000001
111111111111111
100000000000001
100000000000001
100000000000001
100000000000001
100000000000001
1000000E0000001
111111111111111