111111111111111
1000000000000S1
101111111111111
100000000000001
111111111111101
100000001000101
101111101010101
100000101010101
111110101010101
111110101010101
100000100010001
101111111111111
100000000000001
1000000000000E1
111111111111111